.	.		   .
..	Dd		   ..
Uu	Oo   	   Aa
Yy	j    	   Bb
Pp	d          Cc
Bb	v          Dd
Nn	q          Ee
Gg	x          Ff
Kk	c          Gg
Ii	Xx         Hh
Ee	Hh   	   Ii
Ll	Cc   	   Jj
r	Jj   	   Kk
u	Ff   	   Ll
Rr	m    	   Mm
i	Aa         Nn
n	Mm   	   Oo
g	Ll   	   Pp
z	i    	   Qq
t	n          Rr
s	g          Ss
a	z          Tt
f	r          Uu
o	u          Vv
h	Rr         Ww
Ww	t    	   Xx
Ss	o          Yy
Vv	h          Zz
Zz	Ww         a
Dd	Ss   	   b
Hh	Vv   	   c
Aa	Zz   	   d
Mm	Tt   	   e
Oo	l    	   f
Cc	..         g
Jj	Uu   	   h
Ff	Yy   	   i
m	s          j
j	a          k
c	f          l
Xx	Pp   	   m
Tt	e          n
d	y          o
v	p          p
q	Qq   	   q
x	w          r
e	b          s
b	k          t
k	Bb   	   u
l	Nn   	   v
y	Gg   	   w
p	Kk   	   x
Qq	Ii   	   y
w	Ee   	   z














































































































































































































